hello	xin chào
bye	tạm biệt các bạn
apple	quả táo khong ngon
note	ghi chú đẹp
transport	vận chuyển
transfer	truyen
translate	dịch
transgender	chuyển giới
dictionary	từ điển 
bug	con bọ
build	xây dựng
concentration	tập trung

transit	van chuyen 
uniform	dong phuc
xray	x quang
cats	nhieu con meo
cat	con meo
fuck	ád
application	ung dung
thanks	cam on
